00000000000000000000
00000000000000000000
00111110001111100000
00100010001000100000
00100010001000100000
00100010001000100000
00100010001000100000
00113110001101100000
00000000000000000000
00000000000000000000
00220000000000000000
02220000000000000000
00022000000000000000
00000000000000000000
00000000000000000000