00000001111111111111
00000010000000000001
00111100000111100001
00100000001000100001
00100000001060100001
00100000001000100001
00100000001000100001
00111100000111100001
00000010000000000001
00000001111331111111
00000000000000000000
00000000000000000000
00000000000000000000
00000000000000000000
00000000000000000000