00000000000000000000
10111111111111113111
10501111111101000011
15101111111101000111
10101111111010001111
15101111111010011111
10101111110100111111
15100111111001111111
10010011005000511111
10001511111111010000
10000000000011010000
11111111111111010600
00000000001111010000
00000000000011011000
00000000000001000000