11000000000000000000
00000000000000000000
00111100001111100000
00100000001000100000
00100000001000100000
00100000001000100000
00100000001000100000
00113100001101100000
00000000000000000000
00000000000000000000
00220000000000000000
02220000000000000000
00022000000000000000
00000000000000000000
00000000000000000000