00000000000000001000
00001111111000111000
00001111111000110000
00011111111111110000
00111111111000110000
00111111111111110000
00111111111111110000
00111111111111111101
00100000000000000010
00100000000000000010
01000000000600000010
01000000000000000010
01000000000000000100
00111111111115111000
00000000000000000000